┌────┬────────────────┬──┬─────────────────────────┐                                                        
│    │                │  │                         │                                                        
│    │     ┌───────┐  │  │  ┌────────────────┐     │                                                        
│    │     │       │  │  │  │                │     │                                                        
│    │     │  ┌────┘  │  │  │            ┌───┤     │                                                        
│    └─────┘  │       │  │  ├─────       │   └──  ─┤                                                        
│             └───────┘  │  │        │   │         │                                                        
├─────────┐              │  │        │   │   │     │                                                        
│         │     ─────────┘  └─┐      │       │     │                                                        
│         │                   │      └───────┤     │                                                        
│         └────┐   ───────────┤              │     │                                                        
│              │              │              │     │  ██╗     ███████╗██╗   ██╗███████╗██╗         ███████╗ 
│        ┌─────┘        ┌─────┴───────  ─┬───┴─────┤  ██║     ██╔════╝██║   ██║██╔════╝██║         ██╔════╝ 
│        │              │                │         │  ██║     █████╗  ██║   ██║█████╗  ██║         ███████╗ 
│        │              │                │   ──┐   │  ██║     ██╔══╝  ╚██╗ ██╔╝██╔══╝  ██║         ╚════██║ 
├────────┴──────────┐   ├─────────────┐  │     │   │  ███████╗███████╗ ╚████╔╝ ███████╗███████╗    ███████║ 
│                   │   │             │  │     │   │  ╚══════╝╚══════╝  ╚═══╝  ╚══════╝╚══════╝    ╚══════╝ 
│                                     │        │   │                                                        
│  ──┐                                ├──────┬─┘   │                                                        
│    │  ┌──────────┐    ──────────────┘      │     │                                                        
│    │  │          │                         │     │                                                        
│    │  │          ├─────────────────────┬───┘  ───┤                                                        
│    │  └──────────┘                     │         │                                                        
│    │                                   │    E    │                                                        
│    │                                   │         │                                                        
└────┴───────────────────────────────────┴─────────┘                                                        