┌──────────┬─────────────────────────────────┬─────┐                                                        
│          │                                 │     │                                                        
├───────┐  │   │  ┌─────┬─────┐           │  │  │  │                                                        
│       │  │   │  │     │     └───────────┘  └──┘  │                                                        
│    ┌──┘  │   │  └─┐   │                          │                                                        
│    │     │   │    │   ├────────────────┬──────┐  │                                                        
│  ──┘  ───┤   └────┘   │                │      │  │                                                        
│          │            │                │   ──┬┘  │  ██╗     ███████╗██╗   ██╗███████╗██╗         ██╗  ██╗ 
├────────┐ └────────┐   ├─────────────┐  │     │   │  ██║     ██╔════╝██║   ██║██╔════╝██║         ██║  ██║ 
│        │          │   │             │  │     │   │  ██║     █████╗  ██║   ██║█████╗  ██║         ███████║ 
│  ┌─────┘  ┌───────┘                    │     │   │  ██║     ██╔══╝  ╚██╗ ██╔╝██╔══╝  ██║         ╚════██║ 
│  │        │                        ┌───┴───┬─┘   │  ███████╗███████╗ ╚████╔╝ ███████╗███████╗         ██║ 
│  └─┐  ┌───┘   ┌────────────────┐   │       │     │  ╚══════╝╚══════╝  ╚═══╝  ╚══════╝╚══════╝         ╚═╝ 
│    │  │     ┌─┘                └─  │       │     │                                                        
│    │  │   ┌─┘     ────┐                ┌───┘  ───┤                                                        
│    │  └───┘           └────────────────┤         │                                                        
│                                        │    E    │                                                        
└────────────────────────────────────────┴─────────┘                                                        