┌───┬────┬───────────────────┐
│   │    │                   │
│   └────┘                   │
│          ┌──────┬──────┐   │
│    ──────┘      │      │   │
│                 │   │  │   │
│    ──────────┐  │   └──┘   │
│              │  │          │
│    ───────┐  │  └──────────┤
│           │  │             │
│    ─────┐ │  └─────────┐   │
│         │ │            │   │
│    ─────┤ └────────┐   │   │
│         │          │   │ E │
└─────────┴──────────┴───┴───┘