┌─────┬──────────────────────────────────┐                                                        
│     │                                  │                                                        
│     ├───────┐           ┌─────┐        │                                                        
│     │       │   ┌───────┤     │   ┌────┤                                                        
│     │   ────┘   │       │  ───┘   │    │                                                        
│     │           │   ────┘         │    │                                                        
│     │   ┌───────┘           ┌─────┘    │                                                        
│         │           ┌───────┘          │                                                        
│     │   ├────────   │                  │  ██╗     ███████╗██╗   ██╗███████╗██╗         ██████╗  
├─────┴───┘                 ┌────────────┤  ██║     ██╔════╝██║   ██║██╔════╝██║         ╚════██╗ 
│                           │            │  ██║     █████╗  ██║   ██║█████╗  ██║          █████╔╝ 
│       ┌─────────────┐  │  └──────────  │  ██║     ██╔══╝  ╚██╗ ██╔╝██╔══╝  ██║          ╚═══██╗ 
│       │             │  │               │  ███████╗███████╗ ╚████╔╝ ███████╗███████╗    ██████╔╝ 
│       ├─────────┐   │  │               │  ╚══════╝╚══════╝  ╚═══╝  ╚══════╝╚══════╝    ╚═════╝  
│   ┌───┘         │  ─┘  └───────────┐   │                                                        
│   │         ────┘                  │   │                                                        
│   │                                │   │                                                        
│   │  ────────────┐  ┌────────┐     └───┤                                                        
│   │              │  │        │         │                                                        
│   └───────────┐  │  │  ┌──┐  └─────────┤                                                        
│               │  │     │  │         E  │                                                        
└───────────────┴──┴─────┴──┴────────────┘                                                        