┌────────────────────┐
│                    │
│##################  │
│           ##    #  │
│  #######  ##  # #  │
│  #     #  ##  # #  │
│    ##  #  #   ###  │
│#####   #           │
│     #############  │
│                    │
│##################  │
│                 #  │
│    ##############  │
│                    │
│  ################  │
│                    │
│     #  ##########  │
│   ###           #  │
│   ###          ####│
│   ##########       │
│   #        #       │
│   #####    #####   │
│          ###   #   │
│    ####  ##    ##  │
│    ####  ####   E  │
└────────────────────┘